/admin/	django.contrib.admin.sites.index	admin:index
/admin/<app_label>/	django.contrib.admin.sites.app_index	admin:app_list
/admin/<url>	django.contrib.admin.sites.catch_all_view
/admin/account/emailaddress/	django.contrib.admin.options.changelist_view	admin:account_emailaddress_changelist
/admin/account/emailaddress/<path:object_id>/	django.views.generic.base.RedirectView
/admin/account/emailaddress/<path:object_id>/change/	django.contrib.admin.options.change_view	admin:account_emailaddress_change
/admin/account/emailaddress/<path:object_id>/delete/	django.contrib.admin.options.delete_view	admin:account_emailaddress_delete
/admin/account/emailaddress/<path:object_id>/history/	django.contrib.admin.options.history_view	admin:account_emailaddress_history
/admin/account/emailaddress/add/	django.contrib.admin.options.add_view	admin:account_emailaddress_add
/admin/artists/artist/	django.contrib.admin.options.changelist_view	admin:artists_artist_changelist
/admin/artists/artist/<path:object_id>/	django.views.generic.base.RedirectView
/admin/artists/artist/<path:object_id>/change/	django.contrib.admin.options.change_view	admin:artists_artist_change
/admin/artists/artist/<path:object_id>/delete/	django.contrib.admin.options.delete_view	admin:artists_artist_delete
/admin/artists/artist/<path:object_id>/history/	django.contrib.admin.options.history_view	admin:artists_artist_history
/admin/artists/artist/add/	django.contrib.admin.options.add_view	admin:artists_artist_add
/admin/artists/follow/	django.contrib.admin.options.changelist_view	admin:artists_follow_changelist
/admin/artists/follow/<path:object_id>/	django.views.generic.base.RedirectView
/admin/artists/follow/<path:object_id>/change/	django.contrib.admin.options.change_view	admin:artists_follow_change
/admin/artists/follow/<path:object_id>/delete/	django.contrib.admin.options.delete_view	admin:artists_follow_delete
/admin/artists/follow/<path:object_id>/history/	django.contrib.admin.options.history_view	admin:artists_follow_history
/admin/artists/follow/add/	django.contrib.admin.options.add_view	admin:artists_follow_add
/admin/auth/group/	django.contrib.admin.options.changelist_view	admin:auth_group_changelist
/admin/auth/group/<path:object_id>/	django.views.generic.base.RedirectView
/admin/auth/group/<path:object_id>/change/	django.contrib.admin.options.change_view	admin:auth_group_change
/admin/auth/group/<path:object_id>/delete/	django.contrib.admin.options.delete_view	admin:auth_group_delete
/admin/auth/group/<path:object_id>/history/	django.contrib.admin.options.history_view	admin:auth_group_history
/admin/auth/group/add/	django.contrib.admin.options.add_view	admin:auth_group_add
/admin/authtoken/tokenproxy/	django.contrib.admin.options.changelist_view	admin:authtoken_tokenproxy_changelist
/admin/authtoken/tokenproxy/<path:object_id>/	django.views.generic.base.RedirectView
/admin/authtoken/tokenproxy/<path:object_id>/change/	django.contrib.admin.options.change_view	admin:authtoken_tokenproxy_change
/admin/authtoken/tokenproxy/<path:object_id>/delete/	django.contrib.admin.options.delete_view	admin:authtoken_tokenproxy_delete
/admin/authtoken/tokenproxy/<path:object_id>/history/	django.contrib.admin.options.history_view	admin:authtoken_tokenproxy_history
/admin/authtoken/tokenproxy/add/	django.contrib.admin.options.add_view	admin:authtoken_tokenproxy_add
/admin/autocomplete/	django.contrib.admin.sites.autocomplete_view	admin:autocomplete
/admin/jsi18n/	django.contrib.admin.sites.i18n_javascript	admin:jsi18n
/admin/library/library/	django.contrib.admin.options.changelist_view	admin:library_library_changelist
/admin/library/library/<path:object_id>/	django.views.generic.base.RedirectView
/admin/library/library/<path:object_id>/change/	django.contrib.admin.options.change_view	admin:library_library_change
/admin/library/library/<path:object_id>/delete/	django.contrib.admin.options.delete_view	admin:library_library_delete
/admin/library/library/<path:object_id>/history/	django.contrib.admin.options.history_view	admin:library_library_history
/admin/library/library/add/	django.contrib.admin.options.add_view	admin:library_library_add
/admin/listening_history/playcount/	django.contrib.admin.options.changelist_view	admin:listening_history_playcount_changelist
/admin/listening_history/playcount/<path:object_id>/	django.views.generic.base.RedirectView
/admin/listening_history/playcount/<path:object_id>/change/	django.contrib.admin.options.change_view	admin:listening_history_playcount_change
/admin/listening_history/playcount/<path:object_id>/delete/	django.contrib.admin.options.delete_view	admin:listening_history_playcount_delete
/admin/listening_history/playcount/<path:object_id>/history/	django.contrib.admin.options.history_view	admin:listening_history_playcount_history
/admin/listening_history/playcount/add/	django.contrib.admin.options.add_view	admin:listening_history_playcount_add
/admin/listening_history/playhistory/	django.contrib.admin.options.changelist_view	admin:listening_history_playhistory_changelist
/admin/listening_history/playhistory/<path:object_id>/	django.views.generic.base.RedirectView
/admin/listening_history/playhistory/<path:object_id>/change/	django.contrib.admin.options.change_view	admin:listening_history_playhistory_change
/admin/listening_history/playhistory/<path:object_id>/delete/	django.contrib.admin.options.delete_view	admin:listening_history_playhistory_delete
/admin/listening_history/playhistory/<path:object_id>/history/	django.contrib.admin.options.history_view	admin:listening_history_playhistory_history
/admin/listening_history/playhistory/add/	django.contrib.admin.options.add_view	admin:listening_history_playhistory_add
/admin/login/	django.contrib.admin.sites.login	admin:login
/admin/logout/	django.contrib.admin.sites.logout	admin:logout
/admin/music/album/	django.contrib.admin.options.changelist_view	admin:music_album_changelist
/admin/music/album/<path:object_id>/	django.views.generic.base.RedirectView
/admin/music/album/<path:object_id>/change/	django.contrib.admin.options.change_view	admin:music_album_change
/admin/music/album/<path:object_id>/delete/	django.contrib.admin.options.delete_view	admin:music_album_delete
/admin/music/album/<path:object_id>/history/	django.contrib.admin.options.history_view	admin:music_album_history
/admin/music/album/add/	django.contrib.admin.options.add_view	admin:music_album_add
/admin/music/albumtrack/	django.contrib.admin.options.changelist_view	admin:music_albumtrack_changelist
/admin/music/albumtrack/<path:object_id>/	django.views.generic.base.RedirectView
/admin/music/albumtrack/<path:object_id>/change/	django.contrib.admin.options.change_view	admin:music_albumtrack_change
/admin/music/albumtrack/<path:object_id>/delete/	django.contrib.admin.options.delete_view	admin:music_albumtrack_delete
/admin/music/albumtrack/<path:object_id>/history/	django.contrib.admin.options.history_view	admin:music_albumtrack_history
/admin/music/albumtrack/add/	django.contrib.admin.options.add_view	admin:music_albumtrack_add
/admin/music/equalizerpreset/	django.contrib.admin.options.changelist_view	admin:music_equalizerpreset_changelist
/admin/music/equalizerpreset/<path:object_id>/	django.views.generic.base.RedirectView
/admin/music/equalizerpreset/<path:object_id>/change/	django.contrib.admin.options.change_view	admin:music_equalizerpreset_change
/admin/music/equalizerpreset/<path:object_id>/delete/	django.contrib.admin.options.delete_view	admin:music_equalizerpreset_delete
/admin/music/equalizerpreset/<path:object_id>/history/	django.contrib.admin.options.history_view	admin:music_equalizerpreset_history
/admin/music/equalizerpreset/add/	django.contrib.admin.options.add_view	admin:music_equalizerpreset_add
/admin/music/genre/	django.contrib.admin.options.changelist_view	admin:music_genre_changelist
/admin/music/genre/<path:object_id>/	django.views.generic.base.RedirectView
/admin/music/genre/<path:object_id>/change/	django.contrib.admin.options.change_view	admin:music_genre_change
/admin/music/genre/<path:object_id>/delete/	django.contrib.admin.options.delete_view	admin:music_genre_delete
/admin/music/genre/<path:object_id>/history/	django.contrib.admin.options.history_view	admin:music_genre_history
/admin/music/genre/add/	django.contrib.admin.options.add_view	admin:music_genre_add
/admin/music/music/	django.contrib.admin.options.changelist_view	admin:music_music_changelist
/admin/music/music/<path:object_id>/	django.views.generic.base.RedirectView
/admin/music/music/<path:object_id>/change/	django.contrib.admin.options.change_view	admin:music_music_change
/admin/music/music/<path:object_id>/delete/	django.contrib.admin.options.delete_view	admin:music_music_delete
/admin/music/music/<path:object_id>/history/	django.contrib.admin.options.history_view	admin:music_music_history
/admin/music/music/add/	django.contrib.admin.options.add_view	admin:music_music_add
/admin/password_change/	django.contrib.admin.sites.password_change	admin:password_change
/admin/password_change/done/	django.contrib.admin.sites.password_change_done	admin:password_change_done
/admin/playlist/playlist/	django.contrib.admin.options.changelist_view	admin:playlist_playlist_changelist
/admin/playlist/playlist/<path:object_id>/	django.views.generic.base.RedirectView
/admin/playlist/playlist/<path:object_id>/change/	django.contrib.admin.options.change_view	admin:playlist_playlist_change
/admin/playlist/playlist/<path:object_id>/delete/	django.contrib.admin.options.delete_view	admin:playlist_playlist_delete
/admin/playlist/playlist/<path:object_id>/history/	django.contrib.admin.options.history_view	admin:playlist_playlist_history
/admin/playlist/playlist/add/	django.contrib.admin.options.add_view	admin:playlist_playlist_add
/admin/playlist/playlisttrack/	django.contrib.admin.options.changelist_view	admin:playlist_playlisttrack_changelist
/admin/playlist/playlisttrack/<path:object_id>/	django.views.generic.base.RedirectView
/admin/playlist/playlisttrack/<path:object_id>/change/	django.contrib.admin.options.change_view	admin:playlist_playlisttrack_change
/admin/playlist/playlisttrack/<path:object_id>/delete/	django.contrib.admin.options.delete_view	admin:playlist_playlisttrack_delete
/admin/playlist/playlisttrack/<path:object_id>/history/	django.contrib.admin.options.history_view	admin:playlist_playlisttrack_history
/admin/playlist/playlisttrack/add/	django.contrib.admin.options.add_view	admin:playlist_playlisttrack_add
/admin/premium/premiumplan/	django.contrib.admin.options.changelist_view	admin:premium_premiumplan_changelist
/admin/premium/premiumplan/<path:object_id>/	django.views.generic.base.RedirectView
/admin/premium/premiumplan/<path:object_id>/change/	django.contrib.admin.options.change_view	admin:premium_premiumplan_change
/admin/premium/premiumplan/<path:object_id>/delete/	django.contrib.admin.options.delete_view	admin:premium_premiumplan_delete
/admin/premium/premiumplan/<path:object_id>/history/	django.contrib.admin.options.history_view	admin:premium_premiumplan_history
/admin/premium/premiumplan/add/	django.contrib.admin.options.add_view	admin:premium_premiumplan_add
/admin/premium/razorpaytransaction/	django.contrib.admin.options.changelist_view	admin:premium_razorpaytransaction_changelist
/admin/premium/razorpaytransaction/<path:object_id>/	django.views.generic.base.RedirectView
/admin/premium/razorpaytransaction/<path:object_id>/change/	django.contrib.admin.options.change_view	admin:premium_razorpaytransaction_change
/admin/premium/razorpaytransaction/<path:object_id>/delete/	django.contrib.admin.options.delete_view	admin:premium_razorpaytransaction_delete
/admin/premium/razorpaytransaction/<path:object_id>/history/	django.contrib.admin.options.history_view	admin:premium_razorpaytransaction_history
/admin/premium/razorpaytransaction/add/	django.contrib.admin.options.add_view	admin:premium_razorpaytransaction_add
/admin/premium/usersubscription/	django.contrib.admin.options.changelist_view	admin:premium_usersubscription_changelist
/admin/premium/usersubscription/<path:object_id>/	django.views.generic.base.RedirectView
/admin/premium/usersubscription/<path:object_id>/change/	django.contrib.admin.options.change_view	admin:premium_usersubscription_change
/admin/premium/usersubscription/<path:object_id>/delete/	django.contrib.admin.options.delete_view	admin:premium_usersubscription_delete
/admin/premium/usersubscription/<path:object_id>/history/	django.contrib.admin.options.history_view	admin:premium_usersubscription_history
/admin/premium/usersubscription/add/	django.contrib.admin.options.add_view	admin:premium_usersubscription_add
/admin/r/<int:content_type_id>/<path:object_id>/	django.contrib.contenttypes.views.shortcut	admin:view_on_site
/admin/sites/site/	django.contrib.admin.options.changelist_view	admin:sites_site_changelist
/admin/sites/site/<path:object_id>/	django.views.generic.base.RedirectView
/admin/sites/site/<path:object_id>/change/	django.contrib.admin.options.change_view	admin:sites_site_change
/admin/sites/site/<path:object_id>/delete/	django.contrib.admin.options.delete_view	admin:sites_site_delete
/admin/sites/site/<path:object_id>/history/	django.contrib.admin.options.history_view	admin:sites_site_history
/admin/sites/site/add/	django.contrib.admin.options.add_view	admin:sites_site_add
/admin/socialaccount/socialaccount/	django.contrib.admin.options.changelist_view	admin:socialaccount_socialaccount_changelist
/admin/socialaccount/socialaccount/<path:object_id>/	django.views.generic.base.RedirectView
/admin/socialaccount/socialaccount/<path:object_id>/change/	django.contrib.admin.options.change_view	admin:socialaccount_socialaccount_change
/admin/socialaccount/socialaccount/<path:object_id>/delete/	django.contrib.admin.options.delete_view	admin:socialaccount_socialaccount_delete
/admin/socialaccount/socialaccount/<path:object_id>/history/	django.contrib.admin.options.history_view	admin:socialaccount_socialaccount_history
/admin/socialaccount/socialaccount/add/	django.contrib.admin.options.add_view	admin:socialaccount_socialaccount_add
/admin/socialaccount/socialapp/	django.contrib.admin.options.changelist_view	admin:socialaccount_socialapp_changelist
/admin/socialaccount/socialapp/<path:object_id>/	django.views.generic.base.RedirectView
/admin/socialaccount/socialapp/<path:object_id>/change/	django.contrib.admin.options.change_view	admin:socialaccount_socialapp_change
/admin/socialaccount/socialapp/<path:object_id>/delete/	django.contrib.admin.options.delete_view	admin:socialaccount_socialapp_delete
/admin/socialaccount/socialapp/<path:object_id>/history/	django.contrib.admin.options.history_view	admin:socialaccount_socialapp_history
/admin/socialaccount/socialapp/add/	django.contrib.admin.options.add_view	admin:socialaccount_socialapp_add
/admin/socialaccount/socialtoken/	django.contrib.admin.options.changelist_view	admin:socialaccount_socialtoken_changelist
/admin/socialaccount/socialtoken/<path:object_id>/	django.views.generic.base.RedirectView
/admin/socialaccount/socialtoken/<path:object_id>/change/	django.contrib.admin.options.change_view	admin:socialaccount_socialtoken_change
/admin/socialaccount/socialtoken/<path:object_id>/delete/	django.contrib.admin.options.delete_view	admin:socialaccount_socialtoken_delete
/admin/socialaccount/socialtoken/<path:object_id>/history/	django.contrib.admin.options.history_view	admin:socialaccount_socialtoken_history
/admin/socialaccount/socialtoken/add/	django.contrib.admin.options.add_view	admin:socialaccount_socialtoken_add
/admin/token_blacklist/blacklistedtoken/	django.contrib.admin.options.changelist_view	admin:token_blacklist_blacklistedtoken_changelist
/admin/token_blacklist/blacklistedtoken/<path:object_id>/	django.views.generic.base.RedirectView
/admin/token_blacklist/blacklistedtoken/<path:object_id>/change/	django.contrib.admin.options.change_view	admin:token_blacklist_blacklistedtoken_change
/admin/token_blacklist/blacklistedtoken/<path:object_id>/delete/	django.contrib.admin.options.delete_view	admin:token_blacklist_blacklistedtoken_delete
/admin/token_blacklist/blacklistedtoken/<path:object_id>/history/	django.contrib.admin.options.history_view	admin:token_blacklist_blacklistedtoken_history
/admin/token_blacklist/blacklistedtoken/add/	django.contrib.admin.options.add_view	admin:token_blacklist_blacklistedtoken_add
/admin/token_blacklist/outstandingtoken/	django.contrib.admin.options.changelist_view	admin:token_blacklist_outstandingtoken_changelist
/admin/token_blacklist/outstandingtoken/<path:object_id>/	django.views.generic.base.RedirectView
/admin/token_blacklist/outstandingtoken/<path:object_id>/change/	django.contrib.admin.options.change_view	admin:token_blacklist_outstandingtoken_change
/admin/token_blacklist/outstandingtoken/<path:object_id>/delete/	django.contrib.admin.options.delete_view	admin:token_blacklist_outstandingtoken_delete
/admin/token_blacklist/outstandingtoken/<path:object_id>/history/	django.contrib.admin.options.history_view	admin:token_blacklist_outstandingtoken_history
/admin/token_blacklist/outstandingtoken/add/	django.contrib.admin.options.add_view	admin:token_blacklist_outstandingtoken_add
/admin/users/customuser/	django.contrib.admin.options.changelist_view	admin:users_customuser_changelist
/admin/users/customuser/<path:object_id>/	django.views.generic.base.RedirectView
/admin/users/customuser/<path:object_id>/change/	django.contrib.admin.options.change_view	admin:users_customuser_change
/admin/users/customuser/<path:object_id>/delete/	django.contrib.admin.options.delete_view	admin:users_customuser_delete
/admin/users/customuser/<path:object_id>/history/	django.contrib.admin.options.history_view	admin:users_customuser_history
/admin/users/customuser/add/	django.contrib.admin.options.add_view	admin:users_customuser_add
/api/admins/	rest_framework.routers.APIRootView	api-root
/api/admins/<drf_format_suffix:format>	rest_framework.routers.APIRootView	api-root
/api/admins/login/	admins.views.AdminLoginView	admin-login
/api/admins/user-table/	admins.views.UserTableViewSet	customuser-list
/api/admins/user-table/<pk>/	admins.views.UserTableViewSet	customuser-detail
/api/admins/user-table/<pk>\.<format>/	admins.views.UserTableViewSet	customuser-detail
/api/admins/user-table/stats/	admins.views.UserTableViewSet	customuser-stats
/api/admins/user-table/stats\.<format>/	admins.views.UserTableViewSet	customuser-stats
/api/admins/user-table\.<format>/	admins.views.UserTableViewSet	customuser-list
/api/album/	rest_framework.routers.APIRootView	api-root
/api/album/<drf_format_suffix:format>	rest_framework.routers.APIRootView	api-root
/api/album/album_data/	album.views.AlbumData	albumData-list
/api/album/album_data/<pk>/	album.views.AlbumData	albumData-detail
/api/album/album_data/<pk>\.<format>/	album.views.AlbumData	albumData-detail
/api/album/album_data\.<format>/	album.views.AlbumData	albumData-list
/api/album/albums/	album.views.AlbumViewSet	album-list
/api/album/albums/<pk>/	album.views.AlbumViewSet	album-detail
/api/album/albums/<pk>/update_is_public/	album.views.AlbumViewSet	album-update-is-public
/api/album/albums/<pk>/update_is_public\.<format>/	album.views.AlbumViewSet	album-update-is-public
/api/album/albums/<pk>\.<format>/	album.views.AlbumViewSet	album-detail
/api/album/albums/check_album_existence/	album.views.AlbumViewSet	album-check-album-existence
/api/album/albums/check_album_existence\.<format>/	album.views.AlbumViewSet	album-check-album-existence
/api/album/albums/drafts/	album.views.AlbumViewSet	album-drafts
/api/album/albums/drafts\.<format>/	album.views.AlbumViewSet	album-drafts
/api/album/albums/validate_album_name/	album.views.AlbumViewSet	album-validate-album-name
/api/album/albums/validate_album_name\.<format>/	album.views.AlbumViewSet	album-validate-album-name
/api/album/albums\.<format>/	album.views.AlbumViewSet	album-list
/api/album/music/	album.views.MusicViewSet	music-list
/api/album/music/<pk>/	album.views.MusicViewSet	music-detail
/api/album/music/<pk>\.<format>/	album.views.MusicViewSet	music-detail
/api/album/music\.<format>/	album.views.MusicViewSet	music-list
/api/artists/<int:artist_id>/follow/	artists.views.FollowArtistView	follow-artist
/api/artists/<int:artist_id>/followers/	artists.views.ArtistFollowersListView	artist-followers
/api/artists/<int:pk>/update_status/	artists.views.ArtistViewSet	update_status
/api/artists/artist_albumcount/	artists.views.Artist_Albumcount	artist_albumcount
/api/artists/artist_listeners/	artists.views.Artist_listeners	artist_listeners
/api/artists/artist_totalplays/	artists.views.Artist_totalplays	artist_totalplays
/api/artists/artist_trackcount/	artists.views.Artist_Trackcount	artist_trackcount
/api/artists/check-artist-status/	artists.views.check_artist_status	check-artist-status
/api/artists/list_artists/	artists.views.ArtistViewSet	list_artists
/api/artists/me/following/	artists.views.UserFollowingListView	user-following
/api/artists/request_verification/	artists.views.ArtistViewSet	request-verification
/api/artists/update_profile/	artists.views.ArtistViewSet	update_profile
/api/artists/verification_status/	artists.views.ArtistViewSet	verification_status
/api/home/	rest_framework.routers.APIRootView	api-root
/api/home/<drf_format_suffix:format>	rest_framework.routers.APIRootView	api-root
/api/home/albumlist/	home.views.AlbumListView	album-list
/api/home/artistlist/	home.views.ArtistOnlyView	artist-list
/api/home/artistlist/<int:artist_id>/	home.views.ArtistOnlyView	artist-detail
/api/home/by-genre/<int:genre_id>/	home.views.get_music_by_genre	music-by-genre
/api/home/musiclist/	home.views.MusicListView	music-list
/api/home/playlist/	home.views.PlaylistView	playlist-list
/api/home/public_genres/	home.views.PublicGenresViewSet	public_genres-list
/api/home/public_genres/<pk>/	home.views.PublicGenresViewSet	public_genres-detail
/api/home/public_genres/<pk>\.<format>/	home.views.PublicGenresViewSet	public_genres-detail
/api/home/public_genres\.<format>/	home.views.PublicGenresViewSet	public_genres-list
/api/library/	rest_framework.routers.APIRootView	api-root
/api/library/<drf_format_suffix:format>	rest_framework.routers.APIRootView	api-root
/api/library/library/add-playlist/	library.views.LibraryViewSet	library-add-playlist
/api/library/library/add_playlist/	library.views.LibraryViewSet	library-add-playlist
/api/library/library/add_playlist\.<format>/	library.views.LibraryViewSet	library-add-playlist
/api/library/library/check-playlist/<playlist_id>/	library.views.LibraryViewSet	library-check-playlist-in-library
/api/library/library/check-playlist/<playlist_id>\.<format>/	library.views.LibraryViewSet	library-check-playlist-in-library
/api/library/library/playlists/	library.views.LibraryViewSet	library-get-library-playlists
/api/library/library/playlists\.<format>/	library.views.LibraryViewSet	library-get-library-playlists
/api/library/library/remove_playlist/	library.views.LibraryViewSet	library-remove-playlist
/api/library/library/remove_playlist\.<format>/	library.views.LibraryViewSet	library-remove-playlist
/api/library/playlist_data/	library.views.PlaylistViewSet	playlist-list
/api/library/playlist_data/<pk>/	library.views.PlaylistViewSet	playlist-detail
/api/library/playlist_data/<pk>\.<format>/	library.views.PlaylistViewSet	playlist-detail
/api/library/playlist_data\.<format>/	library.views.PlaylistViewSet	playlist-list
/api/library/playlists/	library.views.PlaylistLibraryView	playlist-detail
/api/library/remove_playlist/	library.views.LibraryViewSet	library-remove-playlist
/api/listening_history/recently-played/	listening_history.views.UserRecentlyPlayedView	user-recently-played
/api/music/	rest_framework.routers.APIRootView	api-root
/api/music/<drf_format_suffix:format>	rest_framework.routers.APIRootView	api-root
/api/music/artist/<int:artist_id>/	music.views.SongsByArtistView	songs-by-artist
/api/music/equalizer/current/	music.views.CurrentEqualizerView	current-equalizer
/api/music/equalizer/presets/	music.views.EqualizerPresetListCreateView	equalizer-presets
/api/music/equalizer/presets/<int:pk>/	music.views.EqualizerPresetDetailView	equalizer-preset-detail
/api/music/genres/	music.views.GenreViewSet	genre-list
/api/music/genres/<pk>/	music.views.GenreViewSet	genre-detail
/api/music/genres/<pk>\.<format>/	music.views.GenreViewSet	genre-detail
/api/music/genres\.<format>/	music.views.GenreViewSet	genre-list
/api/music/metadata/<int:music_id>/	music.views.MusicMetadataView
/api/music/music-verification/	music.views.MusicVerificationViewSet	music-verification-list
/api/music/music-verification/<pk>/	music.views.MusicVerificationViewSet	music-verification-detail
/api/music/music-verification/<pk>/approve/	music.views.MusicVerificationViewSet	music-verification-approve
/api/music/music-verification/<pk>/approve\.<format>/	music.views.MusicVerificationViewSet	music-verification-approve
/api/music/music-verification/<pk>/reject/	music.views.MusicVerificationViewSet	music-verification-reject
/api/music/music-verification/<pk>/reject\.<format>/	music.views.MusicVerificationViewSet	music-verification-reject
/api/music/music-verification/<pk>\.<format>/	music.views.MusicVerificationViewSet	music-verification-detail
/api/music/music-verification\.<format>/	music.views.MusicVerificationViewSet	music-verification-list
/api/music/music/	music.views.MusicViewSet	music-list
/api/music/music/<pk>/	music.views.MusicViewSet	music-detail
/api/music/music/<pk>/toggle_visibility/	music.views.MusicViewSet	music-toggle-visibility
/api/music/music/<pk>/toggle_visibility\.<format>/	music.views.MusicViewSet	music-toggle-visibility
/api/music/music/<pk>\.<format>/	music.views.MusicViewSet	music-detail
/api/music/music/check_name/	music.views.MusicViewSet	music-check-name
/api/music/music/check_name\.<format>/	music.views.MusicViewSet	music-check-name
/api/music/music\.<format>/	music.views.MusicViewSet	music-list
/api/music/public-songs/	music.views.PublicSongsView	public-songs
/api/music/stream/<int:music_id>/	music.views.MusicStreamView
/api/music/token/<int:music_id>/	music.views.get_signed_token	music-token
/api/playlist/	rest_framework.routers.APIRootView	api-root
/api/playlist/<drf_format_suffix:format>	rest_framework.routers.APIRootView	api-root
/api/playlist/music/	playlist.views.MusicService	music-list
/api/playlist/music/<pk>/	playlist.views.MusicService	music-detail
/api/playlist/music/<pk>\.<format>/	playlist.views.MusicService	music-detail
/api/playlist/music\.<format>/	playlist.views.MusicService	music-list
/api/playlist/playlist_data/	playlist.views.PlaylistData	playlistData-list
/api/playlist/playlist_data/<pk>/	playlist.views.PlaylistData	playlistData-detail
/api/playlist/playlist_data/<pk>\.<format>/	playlist.views.PlaylistData	playlistData-detail
/api/playlist/playlist_data\.<format>/	playlist.views.PlaylistData	playlistData-list
/api/playlist/playlists/	playlist.views.PlaylistViewSet	playlist-list
/api/playlist/playlists/<pk>/	playlist.views.PlaylistViewSet	playlist-detail
/api/playlist/playlists/<pk>/add_tracks/	playlist.views.PlaylistViewSet	playlist-add-tracks
/api/playlist/playlists/<pk>/add_tracks\.<format>/	playlist.views.PlaylistViewSet	playlist-add-tracks
/api/playlist/playlists/<pk>/remove_tracks/	playlist.views.PlaylistViewSet	playlist-remove-tracks
/api/playlist/playlists/<pk>/remove_tracks\.<format>/	playlist.views.PlaylistViewSet	playlist-remove-tracks
/api/playlist/playlists/<pk>\.<format>/	playlist.views.PlaylistViewSet	playlist-detail
/api/playlist/playlists/is_liked/	playlist.views.PlaylistViewSet	playlist-is-liked
/api/playlist/playlists/is_liked\.<format>/	playlist.views.PlaylistViewSet	playlist-is-liked
/api/playlist/playlists/like_songs/	playlist.views.PlaylistViewSet	playlist-like-songs
/api/playlist/playlists/like_songs\.<format>/	playlist.views.PlaylistViewSet	playlist-like-songs
/api/playlist/playlists\.<format>/	playlist.views.PlaylistViewSet	playlist-list
/api/playlist/public_playlist_data/	playlist.views.PublicPlaylistData	public-playlists
/api/playlist/public_playlist_data/<int:artistId>/	playlist.views.PublicPlaylistData	artist-music-data
/api/premium/	rest_framework.routers.APIRootView	api-root
/api/premium/<drf_format_suffix:format>	rest_framework.routers.APIRootView	api-root
/api/premium/create-order/	premium.views.CreateRazorpayOrderView	create_order
/api/premium/plans/	premium.views.CheckSubscriptionStatusViewSet	premium-plan-list
/api/premium/plans\.<format>/	premium.views.CheckSubscriptionStatusViewSet	premium-plan-list
/api/premium/subscription/status/	premium.views.CheckSubscriptionStatusViewSet	subscription-status-list
/api/premium/subscription/status\.<format>/	premium.views.CheckSubscriptionStatusViewSet	subscription-status-list
/api/premium/transactions/	premium.views.RazorpayTransactionViewSet	razorpay-transaction-list
/api/premium/transactions/<pk>/	premium.views.RazorpayTransactionViewSet	razorpay-transaction-detail
/api/premium/transactions/<pk>\.<format>/	premium.views.RazorpayTransactionViewSet	razorpay-transaction-detail
/api/premium/transactions\.<format>/	premium.views.RazorpayTransactionViewSet	razorpay-transaction-list
/api/premium/verify-payment/	premium.views.VerifyPaymentView	verify_payment
/api/users/	rest_framework.routers.APIRootView	api-root
/api/users/<drf_format_suffix:format>	rest_framework.routers.APIRootView	api-root
/api/users/google_auth/	users.views.google_auth	google_auth
/api/users/google_pre_register/	users.views.google_pre_register	google_pre_register
/api/users/google_register/	users.views.google_register	google_register
/api/users/login/	users.views.login	login
/api/users/logout/	users.views.logout	logout
/api/users/register/complete/	users.views.complete_registration	complete-registration
/api/users/register/initiate/	users.views.initiate_registration	initiate-registration
/api/users/register/resend-otp/	users.views.resend_otp	resend-otp
/api/users/register/verify-otp/	users.views.verify_otp	verify-otp
/api/users/resend-otp/	users.views.login_resend_otp	login_resend-otp
/api/users/token/refresh/	rest_framework_simplejwt.views.TokenRefreshView	token_refresh
/api/users/update/	users.views.update_user	update-user
/api/users/user/	users.views.get_user	get-user
/api/users/verify-otp/	users.views.login_verify_otp	login_verify-otp
/media/<path>	django.views.static.serve
